den	pron
jeg	pron
han	pron
være	vb
og	konj
i	præp
hun	pron
den	art
du	pron
I	pron
min	pron
have	vb
ville	vb
til	præp
en	art
for	præp
med	præp
skulle	vb
af	præp
sin	pron
som	konj
på	præp
gå	vb
kunne	vb
så	adv
din	pron
måtte	vb
sig	pron
vi	pron
der	konj
få	vb
blive	vb
ikke	adv
at	konj
ingen	pron
monne	vb
over	præp
om	præp
hvad	pron
hin	art
fra	præp
vel	adv
eller	konj
ved	præp
anden	pron
under	præp
selv	pron
nu	adv
hos	præp
der	adv
aldrig	adv
da	adv
både	adv
nogen	pron
vor	pron
thi	konj
om	konj
end	konj
denne	pron
foruden	præp
det	konj
alt	adv
begge	pron
imod	præp
hvem	pron
efter	præp
ej	adv
ad	præp	gl. at
men	konj
medens	konj
hver	pron
dog	adv
til	adv
hvor	adv
for	konj
man	pron
dertil	adv
når	konj
ret	adv
igen	adv
længe	adv
her	adv
ganske	adv
alene	adv
også	adv
tilsammen	adv
